AACGTGAT	GATAGACA
AAACATCG	GCCACATA
ATGCCTAA	GCGAGTAA
AGTGGTCA	GCTAACGA
ACCACTGT	GCTCGGTA
ACATTGGC	GGAGAACA
CAGATCTG	GGTGCGAA
CATCAAGT	GTACGCAA
CGCTGATC	GTCGTAGA
ACAAGCTA	GTCTGTCA
CTGTAGCC	GTGTTCTA
AGTACAAG	TAGGATGA
AACAACCA	TATCAGCA
AACCGAGA	TCCGTCTA
AACGCTTA	TCTTCACA
AAGACGGA	TGAAGAGA
AAGGTACA	TGGAACAA
ACACAGAA	TGGCTTCA
ACAGCAGA	TGGTGGTA
ACCTCCAA	TTCACGCA
ACGCTCGA	AACTCACC
ACGTATCA	AAGAGATC
ACTATGCA	AAGGACAC
AGAGTCAA	AATCCGTC
AGATCGCA	AATGTTGC
AGCAGGAA	ACACGACC
AGTCACTA	ACAGATTC
ATCCTGTA	AGATGTAC
ATTGAGGA	AGCACCTC
CAACCACA	AGCCATGC
GACTAGTA	AGGCTAAC
CAATGGAA	ATAGCGAC
CACTTCGA	ATCATTCC
CAGCGTTA	ATTGGCTC
CATACCAA	CAAGGAGC
CCAGTTCA	CACCTTAC
CCGAAGTA	CCATCCTC
CCGTGAGA	CCGACAAC
CCTCCTGA	CCTAATCC
CGAACTTA	CCTCTATC
CGACTGGA	CGACACAC
CGCATACA	CGGATTGC
CTCAATGA	CTAAGGTC
CTGAGCCA	GAACAGGC
CTGGCATA	GACAGTGC
GAATCTGA	GAGTTAGC
CAAGACTA	GATGAATC
GAGCTGAA	GCCAAGAC
